11111111111111111111111111111111111111111111111111
11100000000000000000000000100000000000000000000111
11101111111111111111111110100111111111111111110111
11101000000000000000000010101000000000000000010111
11101001111111111111111010100101111111111111010111
11101010000000000000001010101000000000000001010111
11101001011111111111101010100111111111111101010111
11101010100000000000001010100000000000000101010111
11101001010111111111111010111111111111110101010111
11101010100100000000000010100000000000010101010111
11101001010100111111111110100111111111010101010111
11101010100101000000000010101000000001010101010111
11101001010100101111111010100101111101010101010111
11101010100101010000001010101000001001010101010111
11101001010100101011101010101111100101010101010111
11101010100101010100001010100000101001010101010111
11101001010100101010111010111110010101010101010111
11101010100101010101000010000010101001010101010111
11101000010100100010100010000010000101010001010111
11101111100101111101001111110011111001011111010111
11100000000100000000101000001000000001000000010111
11111111111111111111001000011111111111111111110111
11110000000000000000001000001000000000000000000111
11101111111111111111111000010011111111111111111111
11110100000000100000001000001010000000010000000111
11101001111101001111001110110010111110100111100111
11110101000010101000100001010010100001010100010111
11101001010101010101000010100010101010100101010111
11110101010010101010111001010110101001010101010111
11101001010101010100001010101000101010100101010111
11110101010010101011101001010101101001010101010111
11101001010101010000101010101000001010100101010111
11110101010010101110101001010111111001010101010111
11101001010101000000101010100000000010100101010111
11110101010010111111101001011111111111010101010111
11101001010100000000001010100000000000100101010111
11110101010011111111111001010111111111100101010111
11101001010000000000001010100100000000000101010111
11110101011111111111101001010101111111111101010111
11101001000000000000101010100100000000000001010111
11110101111111111110101001010111111111111111010111
11101000000000000000101010100000000000000000010111
11110111111111111111101001011111111111111111110111
11100000000000000000001001000000000000000000000111
11111111111111111111111111111111111111111111111111
11111111111111111111111111111111111111111111111111
11111111111111111111111111111111111111111111111111
11111111111111111111111111111111111111111111111111
11111111111111111111111111111111111111111111111111
11111111111111111111111111111111111111111111111111
